NO ./textures/renga/renga_north.xpm
SO ./textures/renga/renga_south.xpm
WE ./textures/renga/renga_west.xpm
EA ./textures/renga/renga_east.xpm
F 120,100,80
C 90,90,100


        1111111111
        1000000001
        1000N00001
        1000000001
1111111110000000011111111
1000000000000000000000001
1000000000000000000000001
1111111110000000011111111
        1000000001
        1111111111