NO ./textures/dir/north.xpm
SO ./textures/dir/south.xpm
WE ./textures/dir/west.xpm
EA ./textures/dir/east.xpm
F 60, 60, 60
C 30, 30, 30

111111111111111
100000000000001
100000000000001
100000000000001
100000000000001
100000000000001
1000000N0000001
100000000000001
100000000000000
111111111111111