NO ./textures/renga/renga_north.xpm
SO ./textures/renga/renga_south.xpm
WE ./textures/renga/renga_west.xpm
EA ./textures/renga/renga_east.xpm
F 120,100,80
C 90,90,100

111111
 00001
10N001
111111