NO ./textures/dir/north.xpm
SO ./textures/dir/south.xpm
WE ./textures/dir/west.xpm
EA ./textures/dir/east.xpm
F 60, 60, 60
C 30, 30, 30, 20

111111111111111
100000000000001
100100000000001
100000000010001
100001000000001
100000000000001
1000000S0000001
100000000000001
100000000000001
111111111111111